"season","page_id","team_name","team_short_name","home_away_flag","team_name_opp","team_short_name_opp","points_total","points_total_opp","points_margin","team_result","minutes","field_goals_made","field_goals_attempted","field_goals_percentage","three_pointers_made","three_pointers_attempted","three_pointers_percentage","two_pointers_made","two_pointers_attempted","two_pointers_percentage","free_throws_made","free_throws_attempted","free_throws_percentage","rebounds_defensive","rebounds_offensive","rebounds_total","assists","turnovers","steals","blocks","blocks_received","fouls_personal","fouls_on","points","points_from_turnovers","points_second_chance","points_fast_break","bench_points","points_in_the_paint"
"2015",137220,"SEQ Stars","Stars","home","Bendigo Spirit","Spirit",80,63,17,"W","199:55","32","72","44","4","12","33","28","60","46","12","17","70","26","10","36","15","9","8","1","5","16","20","80","14","8","0","0","44"
"2015",137220,"Bendigo Spirit","Spirit","away","SEQ Stars","Stars",63,80,-17,"L","199:55","26","70","37","1","14","7","25","56","44","10","13","76","28","15","43","8","17","1","5","1","20","16","63","6","4","0","0","40"
"2015",137221,"Perth Lynx","Lynx","home","Sydney Uni Flames","Flames",81,70,11,"W","199:55","30","75","40","8","16","50","22","59","37","13","18","72","25","15","40","18","8","6","4","3","24","19","81","13","15","2","0","34"
"2015",137221,"Sydney Uni Flames","Flames","away","Perth Lynx","Lynx",70,81,-11,"L","199:58","23","58","39","6","20","30","17","38","44","18","25","72","24","10","34","9","15","2","3","4","19","24","70","6","0","0","0","18"
"2015",137222,"Townsville Fire","Fire","home","Bendigo Spirit","Spirit",64,72,-8,"L","199:55","25","58","43","5","13","38","20","45","44","9","14","64","20","5","25","12","17","6","4","1","19","13","64","13","7","0","0","32"
"2015",137222,"Bendigo Spirit","Spirit","away","Townsville Fire","Fire",72,64,8,"W","199:55","25","56","44","5","14","35","20","42","47","17","20","85","25","5","30","16","16","9","1","4","13","19","72","15","3","0","0","38"
"2015",137223,"UC Capitals","Capitals","home","Dandenong Rangers","Rangers",72,80,-8,"L","199:57","28","66","42","6","19","31","22","47","46","10","13","76","22","9","31","17","13","6","3","2","22","16","72","7","6","8","0","30"
"2015",137223,"Dandenong Rangers","Rangers","away","UC Capitals","Capitals",80,72,8,"W","199:56","27","65","41","3","11","27","24","54","44","23","27","85","28","13","41","14","12","8","2","3","16","22","80","12","14","19","0","24"
"2015",137224,"Melbourne Boomers","Boomers","home","Adelaide Lightning","Lightning",94,72,22,"W","199:57","39","81","48","5","23","21","34","58","58","11","15","73","34","14","48","18","13","3","2","0","15","15","94","18","15","0","0","54"
"2015",137224,"Adelaide Lightning","Lightning","away","Melbourne Boomers","Boomers",72,94,-22,"L","199:56","27","73","36","3","10","30","24","63","38","15","19","78","18","11","29","12","13","4","0","2","15","15","72","10","6","2","0","36"
"2015",137225,"Sydney Uni Flames","Flames","home","UC Capitals","Capitals",85,67,18,"W","199:55","29","57","50","7","16","43","22","41","53","20","24","83","27","5","32","17","15","7","0","2","19","22","85","13","4","0","22","30"
"2015",137225,"UC Capitals","Capitals","away","Sydney Uni Flames","Flames",67,85,-18,"L","199:55","26","57","45","4","13","30","22","44","50","11","15","73","19","5","24","12","17","3","2","0","22","19","67","9","4","0","37","24"
"2015",137226,"Dandenong Rangers","Rangers","home","SEQ Stars","Stars",89,81,8,"W","199:57","36","68","52","4","9","44","32","59","54","13","19","68","27","9","36","19","16","4","4","1","12","19","89","11","6","2","23","48"
"2015",137226,"SEQ Stars","Stars","away","Dandenong Rangers","Rangers",81,89,-8,"L","199:58","32","74","43","7","18","38","25","56","44","10","14","71","23","7","30","11","12","11","1","4","19","12","81","10","8","2","7","40"
"2015",137227,"Adelaide Lightning","Lightning","home","Sydney Uni Flames","Flames",71,88,-17,"L","199:53","26","77","33","3","13","23","23","64","35","16","24","66","22","16","38","13","15","9","2","7","23","20","71","10","13","0","19","28"
"2015",137227,"Sydney Uni Flames","Flames","away","Adelaide Lightning","Lightning",88,71,17,"W","199:56","33","64","51","3","15","20","30","49","61","19","27","70","35","10","45","21","15","4","7","2","20","22","88","14","11","0","37","26"
"2015",137228,"Melbourne Boomers","Boomers","home","Perth Lynx","Lynx",68,78,-10,"L","199:56","22","57","38","6","13","46","16","44","36","18","19","94","20","9","29","13","17","2","3","4","16","16","68","9","9","0","0","20"
"2015",137228,"Perth Lynx","Lynx","away","Melbourne Boomers","Boomers",78,68,10,"W","199:57","31","73","42","7","24","29","24","49","48","9","9","100","22","12","34","16","11","7","4","3","16","16","78","16","9","2","14","30"
"2015",137229,"Bendigo Spirit","Spirit","home","Perth Lynx","Lynx",81,65,16,"W","199:51","31","66","46","10","26","38","21","40","52","9","13","69","29","11","40","16","18","5","3","3","20","15","81","10","15","8","12","42"
"2015",137229,"Perth Lynx","Lynx","away","Bendigo Spirit","Spirit",65,81,-16,"L","199:55","22","68","32","5","23","21","17","45","37","16","21","76","19","13","32","10","11","6","3","3","15","20","65","14","10","2","14","16"
"2015",137230,"Townsville Fire","Fire","home","UC Capitals","Capitals",104,60,44,"W","199:54","43","77","55","9","21","42","34","56","60","9","13","69","29","10","39","19","13","8","6","2","25","20","104","29","12","0","28","50"
"2015",137230,"UC Capitals","Capitals","away","Townsville Fire","Fire",60,104,-44,"L","199:53","16","56","28","6","16","37","10","40","25","22","28","78","12","6","18","14","19","1","2","6","20","25","60","9","5","0","26","10"
"2015",137231,"UC Capitals","Capitals","home","SEQ Stars","Stars",58,95,-37,"L","199:53","19","62","30","3","16","18","16","46","34","17","18","94","19","7","26","14","18","13","1","4","13","19","58","8","7","2","10","26"
"2015",137231,"SEQ Stars","Stars","away","UC Capitals","Capitals",95,58,37,"W","199:56","37","72","51","10","16","62","27","56","48","11","14","78","34","12","46","19","18","8","4","1","19","13","95","22","18","4","43","44"
"2015",137232,"Dandenong Rangers","Rangers","home","Bendigo Spirit","Spirit",89,57,32,"W","199:55","33","74","44","6","15","40","27","59","45","17","22","77","27","14","41","16","9","6","7","3","17","21","89","9","9","6","28","38"
"2015",137232,"Bendigo Spirit","Spirit","away","Dandenong Rangers","Rangers",57,89,-32,"L","199:56","18","67","26","0","13","0","18","54","33","21","25","84","21","12","33","13","16","7","3","7","21","17","57","4","2","8","10","26"
"2015",137233,"Bendigo Spirit","Spirit","home","UC Capitals","Capitals",77,66,11,"W","199:55","24","53","45","5","16","31","19","37","51","24","29","82","26","12","38","16","14","8","3","6","19","22","77","14","8","0","4","36"
"2015",137233,"UC Capitals","Capitals","away","Bendigo Spirit","Spirit",66,77,-11,"L","199:55","22","57","38","7","21","33","15","36","41","15","18","83","18","8","26","15","13","4","6","3","22","19","66","11","7","0","5","20"
"2015",137234,"Sydney Uni Flames","Flames","home","Melbourne Boomers","Boomers",93,86,7,"W","199:56","35","55","63","10","17","58","25","38","65","13","16","81","16","7","23","20","21","6","2","2","18","16","93","24","4","0","15","40"
"2015",137234,"Melbourne Boomers","Boomers","away","Sydney Uni Flames","Flames",86,93,-7,"L","199:55","32","62","51","6","15","40","26","47","55","16","20","80","14","13","27","19","19","8","2","2","16","18","86","18","7","0","9","40"
"2015",137235,"Townsville Fire","Fire","home","Adelaide Lightning","Lightning",104,41,63,"W","199:56","35","61","57","13","23","56","22","38","57","21","26","80","36","8","44","21","17","8","3","1","15","23","104","25","9","0","40","34"
"2015",137235,"Adelaide Lightning","Lightning","away","Townsville Fire","Fire",41,104,-63,"L","199:58","16","70","22","1","10","10","15","60","25","8","15","53","19","15","34","6","21","8","1","3","23","15","41","13","8","0","9","18"
"2015",137236,"Perth Lynx","Lynx","home","Dandenong Rangers","Rangers",83,74,9,"W","199:56","30","84","35","8","25","32","22","59","37","15","22","68","23","19","42","12","15","10","4","6","21","21","83","20","0","10","8","42"
"2015",137236,"Dandenong Rangers","Rangers","away","Perth Lynx","Lynx",74,83,-9,"L","199:56","28","69","40","2","4","50","26","65","40","16","19","84","29","10","39","15","20","6","6","4","21","21","74","12","15","0","14","32"
"2015",137237,"SEQ Stars","Stars","home","Adelaide Lightning","Lightning",104,74,30,"W","199:47","36","76","47","13","27","48","23","49","46","19","24","79","25","13","38","16","10","4","1","2","20","21","104","22","20","0","19","32"
"2015",137237,"Adelaide Lightning","Lightning","away","SEQ Stars","Stars",74,104,-30,"L","198:22","25","69","36","3","21","14","22","48","45","21","26","80","27","15","42","11","18","4","2","1","21","20","74","11","8","0","18","30"
"2015",137238,"Perth Lynx","Lynx","home","Bendigo Spirit","Spirit",67,73,-6,"L","199:56","23","74","31","6","25","24","17","49","34","15","21","71","27","17","44","13","13","5","11","5","18","15","67","9","8","0","7","22"
"2015",137238,"Bendigo Spirit","Spirit","away","Perth Lynx","Lynx",73,67,6,"W","199:57","25","71","35","3","19","15","22","52","42","20","24","83","26","11","37","14","11","9","5","11","15","18","73","10","16","0","8","36"
"2015",137239,"SEQ Stars","Stars","home","Sydney Uni Flames","Flames",97,89,8,"W","224:56","36","79","45","4","19","21","32","60","53","21","26","80","28","20","48","11","16","6","2","5","19","21","97","19","13","0","15","52"
"2015",137239,"Sydney Uni Flames","Flames","away","SEQ Stars","Stars",89,97,-8,"L","224:56","33","68","48","6","17","35","27","51","52","17","21","80","26","6","32","19","18","5","5","2","21","19","89","20","8","0","11","44"
"2015",137240,"Dandenong Rangers","Rangers","home","Townsville Fire","Fire",75,83,-8,"L","199:55","33","70","47","4","8","50","29","62","46","5","7","71","27","4","31","11","12","4","3","4","19","14","75","8","0","0","12","44"
"2015",137240,"Townsville Fire","Fire","away","Dandenong Rangers","Rangers",83,75,8,"W","199:56","30","75","40","1","16","6","29","59","49","22","26","84","29","13","42","13","12","3","4","3","14","19","83","8","10","0","6","38"
"2015",137241,"UC Capitals","Capitals","home","Melbourne Boomers","Boomers",63,91,-28,"L","199:55","25","66","37","5","14","35","20","52","38","8","15","53","22","10","32","15","20","6","4","4","11","18","63","10","8","2","24","34"
"2015",137241,"Melbourne Boomers","Boomers","away","UC Capitals","Capitals",91,63,28,"W","199:55","40","85","47","8","24","33","32","61","52","3","6","50","29","18","47","19","15","11","4","4","18","11","91","30","25","10","24","42"
"2015",137242,"Adelaide Lightning","Lightning","home","Bendigo Spirit","Spirit",76,68,8,"W","199:56","27","69","39","6","17","35","21","52","40","16","18","88","31","13","44","13","10","5","2","3","16","21","76","10","13","0","11","24"
"2015",137242,"Bendigo Spirit","Spirit","away","Adelaide Lightning","Lightning",68,76,-8,"L","199:57","26","66","39","11","26","42","15","40","37","5","9","55","27","7","34","16","14","4","3","2","21","16","68","7","12","0","4","30"
"2015",137243,"Melbourne Boomers","Boomers","home","Townsville Fire","Fire",84,75,9,"W","199:55","32","66","48","8","19","42","24","47","51","12","14","85","29","11","40","19","19","4","1","4","16","17","84","15","4","2","10","8"
"2015",137243,"Townsville Fire","Fire","away","Melbourne Boomers","Boomers",75,84,-9,"L","199:55","32","74","43","4","16","25","28","58","48","7","13","53","20","7","27","12","13","6","4","1","17","16","75","14","9","4","10","52"
"2015",137244,"Sydney Uni Flames","Flames","home","UC Capitals","Capitals",68,45,23,"W","199:54","26","61","42","7","17","41","19","44","43","9","12","75","29","14","43","16","16","5","7","2","14","17","68","12","11","0","18","28"
"2015",137244,"UC Capitals","Capitals","away","Sydney Uni Flames","Flames",45,68,-23,"L","199:57","21","64","32","0","11","0","21","53","39","3","7","42","14","10","24","7","11","5","2","7","17","14","45","12","8","0","10","32"
"2015",137245,"Dandenong Rangers","Rangers","home","Melbourne Boomers","Boomers",75,69,6,"W","199:56","23","60","38","5","10","50","18","50","36","24","32","75","25","9","34","8","13","7","2","3","20","25","75","6","3","4","15","26"
"2015",137245,"Melbourne Boomers","Boomers","away","Dandenong Rangers","Rangers",69,75,-6,"L","199:55","24","61","39","8","22","36","16","39","41","13","16","81","26","7","33","18","20","1","3","2","25","20","69","8","7","0","24","24"
"2015",137246,"Bendigo Spirit","Spirit","home","SEQ Stars","Stars",84,79,5,"W","199:57","30","69","43","4","14","28","26","55","47","20","22","90","29","13","42","19","14","6","10","7","19","19","84","8","10","2","11","40"
"2015",137246,"SEQ Stars","Stars","away","Bendigo Spirit","Spirit",79,84,-5,"L","199:57","32","76","42","6","21","28","26","55","47","9","17","52","20","12","32","12","9","5","7","10","19","19","79","18","4","2","13","42"
"2015",137247,"Townsville Fire","Fire","home","Sydney Uni Flames","Flames",70,73,-3,"L","199:55","26","73","35","2","8","25","24","65","36","16","20","80","26","13","39","14","11","3","3","2","19","19","70","8","7","0","17","38"
"2015",137247,"Sydney Uni Flames","Flames","away","Townsville Fire","Fire",73,70,3,"W","199:56","26","68","38","2","12","16","24","56","42","19","23","82","29","10","39","13","12","6","2","3","19","19","73","13","11","0","15","32"
"2015",137248,"Adelaide Lightning","Lightning","home","Perth Lynx","Lynx",52,65,-13,"L","199:54","18","71","25","3","21","14","15","50","30","13","20","65","25","15","40","12","16","10","0","5","15","19","52","9","4","0","20","22"
"2015",137248,"Perth Lynx","Lynx","away","Adelaide Lightning","Lightning",65,52,13,"W","199:55","26","67","38","7","26","26","19","41","46","6","10","60","32","10","42","22","19","5","4","0","19","15","65","11","8","0","13","30"
"2015",137249,"Melbourne Boomers","Boomers","home","SEQ Stars","Stars",64,76,-12,"L","199:34","23","56","41","5","16","31","18","40","45","13","16","81","23","10","33","16","25","4","8","1","16","19","64","9","9","6","4","26"
"2015",137249,"SEQ Stars","Stars","away","Melbourne Boomers","Boomers",76,64,12,"W","199:56","27","70","38","8","15","53","19","55","34","14","16","87","20","11","31","18","16","10","1","8","19","16","76","20","12","12","28","28"
"2015",137250,"Perth Lynx","Lynx","home","Dandenong Rangers","Rangers",83,66,17,"W","199:54","33","74","44","7","21","33","26","53","49","10","10","100","18","14","32","17","16","8","8","2","11","12","83","15","10","2","29","32"
"2015",137250,"Dandenong Rangers","Rangers","away","Perth Lynx","Lynx",66,83,-17,"L","199:53","27","78","34","4","17","23","23","61","37","8","10","80","18","22","40","13","18","4","2","8","12","11","66","9","13","0","25","34"
"2015",137251,"Sydney Uni Flames","Flames","home","Adelaide Lightning","Lightning",84,79,5,"W","199:56","29","59","49","8","16","50","21","43","48","18","19","94","24","7","31","15","16","2","5","3","13","21","84","21","9","0","23","22"
"2015",137251,"Adelaide Lightning","Lightning","away","Sydney Uni Flames","Flames",79,84,-5,"L","199:55","30","68","44","8","19","42","22","49","44","11","15","73","19","11","30","16","14","8","3","5","21","13","79","20","12","0","13","28"
"2015",137252,"SEQ Stars","Stars","home","Melbourne Boomers","Boomers",78,62,16,"W","199:56","28","70","40","6","22","27","22","48","45","16","19","84","28","13","41","10","12","7","4","5","13","18","78","15","5","2","27","34"
"2015",137252,"Melbourne Boomers","Boomers","away","SEQ Stars","Stars",62,78,-16,"L","199:55","24","61","39","6","15","40","18","46","39","8","10","80","26","7","33","9","19","3","5","4","19","13","62","2","5","2","4","18"
"2015",137253,"UC Capitals","Capitals","home","Adelaide Lightning","Lightning",71,78,-7,"L","199:55","23","68","33","5","22","22","18","46","39","20","22","90","18","12","30","13","10","7","9","0","18","24","71","13","7","2","29","34"
"2015",137253,"Adelaide Lightning","Lightning","away","UC Capitals","Capitals",78,71,7,"W","199:57","29","74","39","5","10","50","24","64","37","15","18","83","33","19","52","11","16","3","0","9","24","18","78","8","13","0","37","32"
"2015",137254,"Bendigo Spirit","Spirit","home","Perth Lynx","Lynx",73,86,-13,"L","199:55","25","68","36","9","24","37","16","44","36","14","18","77","19","16","35","16","20","8","3","6","23","17","73","18","13","7","10","28"
"2015",137254,"Perth Lynx","Lynx","away","Bendigo Spirit","Spirit",86,73,13,"W","199:55","29","62","46","11","24","45","18","38","47","17","20","85","17","10","27","17","15","12","6","3","17","23","86","21","5","2","27","20"
"2015",137255,"Townsville Fire","Fire","home","Melbourne Boomers","Boomers",85,57,28,"W","199:55","30","72","41","4","13","30","26","59","44","21","24","87","32","19","51","17","20","7","2","8","14","17","85","13","14","0","33","38"
"2015",137255,"Melbourne Boomers","Boomers","away","Townsville Fire","Fire",57,85,-28,"L","199:55","24","72","33","3","20","15","21","52","40","6","7","85","17","10","27","14","14","7","8","2","17","14","57","13","8","0","9","30"
"2015",137256,"Perth Lynx","Lynx","home","Adelaide Lightning","Lightning",93,85,8,"W","199:56","36","66","54","9","25","36","27","41","65","12","17","70","24","11","35","17","21","12","5","1","13","19","93","19","12","2","25","40"
"2015",137256,"Adelaide Lightning","Lightning","away","Perth Lynx","Lynx",85,93,-8,"L","199:56","33","64","51","7","16","43","26","48","54","12","15","80","18","4","22","24","19","14","1","5","19","13","85","21","2","0","23","42"
"2015",137257,"SEQ Stars","Stars","home","Townsville Fire","Fire",85,88,-3,"L","199:56","34","77","44","11","21","52","23","56","41","6","8","75","22","11","33","14","11","7","3","6","22","12","85","16","10","6","34","38"
"2015",137257,"Townsville Fire","Fire","away","SEQ Stars","Stars",88,85,3,"W","199:56","35","67","52","2","10","20","33","57","57","16","19","84","30","7","37","12","19","5","6","3","12","21","88","8","7","2","15","46"
"2015",137258,"Sydney Uni Flames","Flames","home","SEQ Stars","Stars",94,69,25,"W","199:56","34","62","54","8","20","40","26","42","61","18","19","94","36","2","38","21","18","5","5","2","17","22","94","18","0","0","15","28"
"2015",137258,"SEQ Stars","Stars","away","Sydney Uni Flames","Flames",69,94,-25,"L","199:56","26","76","34","4","21","19","22","55","40","13","17","76","16","11","27","11","15","7","2","5","22","17","69","6","8","0","17","36"
"2015",137259,"Melbourne Boomers","Boomers","home","Bendigo Spirit","Spirit",78,58,20,"W","199:50","27","59","45","9","19","47","18","40","45","15","17","88","29","11","40","17","14","6","3","3","17","16","78","11","14","0","3","20"
"2015",137259,"Bendigo Spirit","Spirit","away","Melbourne Boomers","Boomers",58,78,-20,"L","199:55","22","63","34","6","18","33","16","45","35","8","13","61","16","12","28","17","12","4","3","3","16","17","58","9","9","0","12","28"
"2015",137260,"Bendigo Spirit","Spirit","home","Dandenong Rangers","Rangers",63,49,14,"W","199:55","22","63","34","6","18","33","16","45","35","13","16","81","23","12","35","17","20","8","3","4","12","18","63","13","5","7","9","22"
"2015",137260,"Dandenong Rangers","Rangers","away","Bendigo Spirit","Spirit",49,63,-14,"L","199:54","20","58","34","0","6","0","20","52","38","9","11","81","25","12","37","4","22","11","4","3","18","12","49","10","4","5","6","24"
"2015",137261,"UC Capitals","Capitals","home","Townsville Fire","Fire",66,84,-18,"L","199:56","25","64","39","3","17","17","22","47","46","13","17","76","17","6","23","10","16","8","0","3","22","18","66","14","4","0","16","36"
"2015",137261,"Townsville Fire","Fire","away","UC Capitals","Capitals",84,66,18,"W","199:55","28","63","44","3","13","23","25","50","50","25","30","83","25","13","38","17","15","9","3","0","19","22","84","15","9","4","16","42"
"2015",137262,"Dandenong Rangers","Rangers","home","Sydney Uni Flames","Flames",85,65,20,"W","199:55","33","68","48","5","13","38","28","55","50","14","17","82","22","8","30","23","10","7","2","2","16","17","85","18","6","10","21","38"
"2015",137262,"Sydney Uni Flames","Flames","away","Dandenong Rangers","Rangers",65,85,-20,"L","199:56","24","58","41","2","18","11","22","40","55","15","16","93","21","7","28","5","18","4","2","2","17","16","65","8","8","11","20","44"
"2015",137263,"Townsville Fire","Fire","home","Perth Lynx","Lynx",91,81,10,"W","199:55","35","68","51","7","21","33","28","47","59","14","18","77","29","9","38","16","13","5","2","2","12","15","91","15","4","10","14","46"
"2015",137263,"Perth Lynx","Lynx","away","Townsville Fire","Fire",81,91,-10,"L","199:56","31","77","40","11","28","39","20","49","40","8","9","88","17","11","28","11","11","4","2","2","15","12","81","17","7","4","6","26"
"2015",137264,"UC Capitals","Capitals","home","Melbourne Boomers","Boomers",61,66,-5,"L","188:46","21","43","48","3","11","27","18","32","56","16","26","61","19","5","24","8","19","4","0","1","21","18","61","4","6","0","9","24"
"2015",137264,"Melbourne Boomers","Boomers","away","UC Capitals","Capitals",66,61,5,"W","201:47","26","50","52","5","10","50","21","40","52","9","16","56","18","6","24","9","12","8","1","0","20","20","66","13","6","0","27","28"
"2015",137265,"Adelaide Lightning","Lightning","home","Bendigo Spirit","Spirit",73,89,-16,"L","199:54","28","75","37","4","13","30","24","62","38","13","21","61","17","15","32","15","14","7","3","6","19","16","73","10","10","0","22","36"
"2015",137265,"Bendigo Spirit","Spirit","away","Adelaide Lightning","Lightning",89,73,16,"W","199:55","33","60","55","10","22","45","23","38","60","13","16","81","26","9","35","20","16","8","6","3","16","19","89","18","14","6","15","32"
"2015",137266,"SEQ Stars","Stars","home","Perth Lynx","Lynx",64,85,-21,"L","199:56","26","70","37","6","20","30","20","50","40","6","10","60","16","11","27","7","16","7","3","4","13","12","64","16","12","0","5","34"
"2015",137266,"Perth Lynx","Lynx","away","SEQ Stars","Stars",85,64,21,"W","199:55","33","67","49","7","21","33","26","46","56","12","14","85","28","15","43","14","20","4","4","3","12","13","85","19","17","2","10","40"
"2015",137267,"UC Capitals","Capitals","home","Sydney Uni Flames","Flames",76,82,-6,"L","199:56","26","62","41","6","21","28","20","41","48","18","24","75","18","5","23","11","13","8","1","1","24","23","76","14","0","8","19","34"
"2015",137267,"Sydney Uni Flames","Flames","away","UC Capitals","Capitals",82,76,6,"W","199:55","27","55","49","4","11","36","23","44","52","24","29","82","26","8","34","12","21","5","1","1","23","24","82","15","4","0","17","28"
"2015",137268,"Sydney Uni Flames","Flames","home","Adelaide Lightning","Lightning",67,94,-27,"L","199:54","27","61","44","2","13","15","25","48","52","11","13","84","18","5","23","16","11","3","1","5","19","17","67","11","6","0","12","30"
"2015",137268,"Adelaide Lightning","Lightning","away","Sydney Uni Flames","Flames",94,67,27,"W","199:55","37","67","55","6","16","37","31","51","60","14","15","93","26","9","35","20","11","5","5","1","17","19","94","12","6","0","10","48"
"2015",137269,"Townsville Fire","Fire","home","Bendigo Spirit","Spirit",68,84,-16,"L","199:56","26","63","41","6","19","31","20","44","45","10","13","76","23","8","31","15","19","6","4","3","17","12","68","7","9","5","12","28"
"2015",137269,"Bendigo Spirit","Spirit","away","Townsville Fire","Fire",84,68,16,"W","199:57","28","65","43","12","25","48","16","40","40","16","20","80","25","12","37","18","16","3","3","4","12","17","84","9","8","8","7","28"
"2015",137270,"Dandenong Rangers","Rangers","home","Perth Lynx","Lynx",65,63,2,"W","199:55","26","69","37","2","14","14","24","55","43","11","12","91","31","10","41","11","10","4","3","5","16","16","65","4","2","7","10","32"
"2015",137270,"Perth Lynx","Lynx","away","Dandenong Rangers","Rangers",63,65,-2,"L","199:56","23","68","33","7","22","31","16","46","34","10","14","71","26","9","35","16","11","3","5","3","16","16","63","8","4","2","18","22"
"2015",137271,"Melbourne Boomers","Boomers","home","Perth Lynx","Lynx",73,84,-11,"L","199:55","28","65","43","10","22","45","18","43","41","7","12","58","17","13","30","13","18","2","2","1","17","15","73","17","9","3","9","24"
"2015",137271,"Perth Lynx","Lynx","away","Melbourne Boomers","Boomers",84,73,11,"W","199:56","33","67","49","6","16","37","27","51","52","12","13","92","23","11","34","14","18","11","1","2","15","17","84","15","18","4","16","36"
"2015",137272,"Adelaide Lightning","Lightning","home","Dandenong Rangers","Rangers",72,70,2,"W","199:55","27","62","43","3","14","21","24","48","50","15","19","78","18","8","26","15","14","13","2","1","17","18","72","14","6","0","12","32"
"2015",137272,"Dandenong Rangers","Rangers","away","Adelaide Lightning","Lightning",70,72,-2,"L","199:58","28","61","45","6","17","35","22","44","50","8","10","80","24","12","36","16","21","4","1","2","18","17","70","14","10","0","2","28"
"2015",137273,"SEQ Stars","Stars","home","Bendigo Spirit","Spirit",88,97,-9,"L","199:56","32","63","50","7","22","31","25","41","60","17","27","62","21","9","30","18","13","2","7","2","19","20","88","26","7","0","25","40"
"2015",137273,"Bendigo Spirit","Spirit","away","SEQ Stars","Stars",97,88,9,"W","199:57","36","69","52","11","18","61","25","51","49","14","16","87","23","12","35","22","14","6","2","7","20","19","97","15","14","2","5","44"
"2015",137274,"Perth Lynx","Lynx","home","SEQ Stars","Stars",85,67,18,"W","199:55","30","80","37","10","32","31","20","48","41","15","22","68","34","17","51","22","8","8","8","3","18","15","85","16","13","2","19","32"
"2015",137274,"SEQ Stars","Stars","away","Perth Lynx","Lynx",67,85,-18,"L","199:57","22","70","31","5","21","23","17","49","34","18","21","85","29","14","43","13","12","4","3","8","15","18","67","4","15","0","13","24"
"2015",137275,"Dandenong Rangers","Rangers","home","UC Capitals","Capitals",84,80,4,"W","199:57","32","63","50","5","15","33","27","48","56","15","17","88","24","14","38","14","22","5","1","1","16","18","84","11","15","3","10","34"
"2015",137275,"UC Capitals","Capitals","away","Dandenong Rangers","Rangers",80,84,-4,"L","199:54","29","65","44","10","27","37","19","38","50","12","17","70","15","13","28","14","16","5","1","1","19","16","80","7","6","6","15","32"
"2015",137276,"Bendigo Spirit","Spirit","home","Melbourne Boomers","Boomers",65,70,-5,"L","199:55","21","69","30","7","27","25","14","42","33","16","19","84","22","16","38","13","17","11","6","7","22","17","65","15","5","4","3","20"
"2015",137276,"Melbourne Boomers","Boomers","away","Bendigo Spirit","Spirit",70,65,5,"W","199:56","23","57","40","12","23","52","11","34","32","12","19","63","26","10","36","18","19","8","7","6","17","22","70","9","9","0","6","16"
"2015",137277,"Sydney Uni Flames","Flames","home","Townsville Fire","Fire",78,79,-1,"L","224:56","30","73","41","5","21","23","25","52","48","13","18","72","29","9","38","19","14","9","2","3","11","15","78","15","4","0","17","26"
"2015",137277,"Townsville Fire","Fire","away","Sydney Uni Flames","Flames",79,78,1,"W","224:55","34","79","43","4","13","30","30","66","45","7","10","70","28","13","41","20","16","5","3","2","15","11","79","14","13","0","11","44"
"2015",137278,"Adelaide Lightning","Lightning","home","SEQ Stars","Stars",61,72,-11,"L","199:54","23","58","39","2","9","22","21","49","42","13","18","72","26","9","35","9","17","7","4","4","17","16","61","12","2","2","25","28"
"2015",137278,"SEQ Stars","Stars","away","Adelaide Lightning","Lightning",72,61,11,"W","199:56","25","65","38","10","25","40","15","40","37","12","12","100","24","10","34","18","14","7","4","4","16","17","72","10","2","0","18","20"
"2015",137279,"Melbourne Boomers","Boomers","home","UC Capitals","Capitals",78,75,3,"W","199:57","32","73","43","13","28","46","19","45","42","1","2","50","28","7","35","20","6","3","1","3","11","11","78","12","5","0","19","26"
"2015",137279,"UC Capitals","Capitals","away","Melbourne Boomers","Boomers",75,78,-3,"L","199:57","30","65","46","9","18","50","21","47","44","6","10","60","24","4","28","15","7","1","3","1","11","11","75","14","6","0","8","28"
"2015",137280,"Perth Lynx","Lynx","home","UC Capitals","Capitals",88,68,20,"W","199:53","35","79","44","7","22","31","28","57","49","11","13","84","26","15","41","16","14","12","5","10","15","12","88","18","6","2","23","48"
"2015",137280,"UC Capitals","Capitals","away","Perth Lynx","Lynx",68,88,-20,"L","199:57","26","62","41","8","21","38","18","41","43","8","10","80","23","7","30","12","22","7","10","5","12","15","68","15","3","4","24","26"
"2015",137281,"Bendigo Spirit","Spirit","home","Sydney Uni Flames","Flames",64,67,-3,"L","199:57","21","60","35","6","20","30","15","40","37","16","18","88","24","11","35","8","12","4","5","4","23","14","64","9","4","2","2","20"
"2015",137281,"Sydney Uni Flames","Flames","away","Bendigo Spirit","Spirit",67,64,3,"W","199:55","25","69","36","7","12","58","18","57","31","10","14","71","23","18","41","8","13","2","4","5","15","23","67","3","6","0","15","24"
"2015",137282,"Dandenong Rangers","Rangers","home","Melbourne Boomers","Boomers",76,70,6,"W","199:54","30","64","46","2","8","25","28","56","50","14","17","82","21","11","32","7","12","4","2","1","11","19","76","12","14","3","7","36"
"2015",137282,"Melbourne Boomers","Boomers","away","Dandenong Rangers","Rangers",70,76,-6,"L","199:55","29","60","48","7","19","36","22","41","53","5","8","62","22","7","29","11","15","4","1","2","19","11","70","6","9","3","9","26"
"2015",137283,"SEQ Stars","Stars","home","Townsville Fire","Fire",95,75,20,"W","199:56","38","78","48","9","21","42","29","57","50","10","11","90","25","11","36","18","9","4","5","4","16","10","95","24","11","0","16","28"
"2015",137283,"Townsville Fire","Fire","away","SEQ Stars","Stars",75,95,-20,"L","199:56","25","63","39","2","14","14","23","49","46","23","23","100","23","7","30","15","17","3","4","5","10","16","75","4","8","0","9","34"
"2015",137284,"Adelaide Lightning","Lightning","home","UC Capitals","Capitals",75,68,7,"W","199:55","27","70","38","5","16","31","22","54","40","16","25","64","29","15","44","20","16","7","1","3","24","18","75","7","12","0","18","30"
"2015",137284,"UC Capitals","Capitals","away","Adelaide Lightning","Lightning",68,75,-7,"L","199:55","22","58","37","2","16","12","20","42","47","22","28","78","28","7","35","9","17","6","3","1","18","24","68","12","4","0","10","34"
"2015",137285,"Melbourne Boomers","Boomers","home","Sydney Uni Flames","Flames",62,65,-3,"L","199:55","21","58","36","8","24","33","13","34","38","12","15","80","18","17","35","13","21","9","4","0","20","15","62","13","19","0","11","12"
"2015",137285,"Sydney Uni Flames","Flames","away","Melbourne Boomers","Boomers",65,62,3,"W","199:55","26","56","46","5","15","33","21","41","51","8","12","66","14","5","19","14","15","6","0","3","15","20","65","14","5","6","11","24"
"2015",137286,"Townsville Fire","Fire","home","Dandenong Rangers","Rangers",70,61,9,"W","199:55","25","67","37","10","24","41","15","43","34","10","14","71","28","10","38","20","14","0","4","3","12","12","70","9","4","0","8","24"
"2015",137286,"Dandenong Rangers","Rangers","away","Townsville Fire","Fire",61,70,-9,"L","199:57","25","70","35","2","14","14","23","56","41","9","12","75","25","9","34","7","10","4","3","4","12","12","61","16","11","0","9","28"
"2015",137287,"Perth Lynx","Lynx","home","Townsville Fire","Fire",71,77,-6,"L","199:56","28","76","36","6","25","24","22","51","43","9","11","81","21","15","36","11","14","11","0","7","14","12","71","15","13","0","10","32"
"2015",137287,"Townsville Fire","Fire","away","Perth Lynx","Lynx",77,71,6,"W","199:50","31","56","55","9","17","52","22","39","56","6","9","66","25","3","28","19","20","5","7","0","12","14","77","13","2","0","21","36"
"2015",137288,"Sydney Uni Flames","Flames","home","Melbourne Boomers","Boomers",86,78,8,"W","199:56","31","60","51","10","22","45","21","38","55","14","16","87","21","8","29","19","15","7","4","2","16","18","86","18","10","0","24","24"
"2015",137288,"Melbourne Boomers","Boomers","away","Sydney Uni Flames","Flames",78,86,-8,"L","199:56","26","59","44","11","24","45","15","35","42","15","19","78","16","11","27","15","18","6","2","4","18","16","78","9","2","0","31","26"
"2015",137289,"Bendigo Spirit","Spirit","home","UC Capitals","Capitals",78,68,10,"W","199:55","31","68","45","6","19","31","25","49","51","10","12","83","26","8","34","20","11","8","2","4","15","12","78","9","2","2","8","42"
"2015",137289,"UC Capitals","Capitals","away","Bendigo Spirit","Spirit",68,78,-10,"L","199:57","24","60","40","3","13","23","21","47","44","17","19","89","25","6","31","10","13","4","4","2","12","15","68","7","4","1","7","36"
"2015",137290,"SEQ Stars","Stars","home","Dandenong Rangers","Rangers",66,72,-6,"L","199:55","23","76","30","4","22","18","19","54","35","16","18","88","28","18","46","9","10","5","4","4","20","17","66","5","7","0","16","26"
"2015",137290,"Dandenong Rangers","Rangers","away","SEQ Stars","Stars",72,66,6,"W","199:42","25","61","40","4","9","44","21","52","40","18","23","78","28","4","32","11","11","4","4","4","17","20","72","4","4","0","13","30"
"2015",137291,"Adelaide Lightning","Lightning","home","Townsville Fire","Fire",60,88,-28,"L","199:56","22","63","34","6","15","40","16","48","33","10","20","50","15","15","30","10","15","5","2","7","21","13","60","11","17","0","12","22"
"2015",137291,"Townsville Fire","Fire","away","Adelaide Lightning","Lightning",88,60,28,"W","199:54","33","67","49","8","26","30","25","41","60","14","24","58","27","17","44","22","11","6","7","2","13","21","88","11","10","0","21","40"
"2015",137292,"Sydney Uni Flames","Flames","home","Perth Lynx","Lynx",83,73,10,"W","199:56","28","63","44","6","19","31","22","44","50","21","21","100","25","9","34","18","13","5","8","2","16","19","83","13","8","0","22","28"
"2015",137292,"Perth Lynx","Lynx","away","Sydney Uni Flames","Flames",73,83,-10,"L","199:55","27","70","38","7","27","25","20","43","46","12","14","85","20","14","34","11","17","8","2","8","19","16","73","16","10","0","18","32"
"2015",137293,"Adelaide Lightning","Lightning","home","Dandenong Rangers","Rangers",63,79,-16,"L","199:56","22","67","32","6","21","28","16","46","34","13","20","65","17","14","31","15","16","10","0","5","20","14","63","14","8","2","13","22"
"2015",137293,"Dandenong Rangers","Rangers","away","Adelaide Lightning","Lightning",79,63,16,"W","199:56","28","55","50","3","9","33","25","46","54","20","25","80","24","7","31","18","17","7","5","0","14","20","79","18","6","2","16","26"
"2015",137294,"Dandenong Rangers","Rangers","home","Sydney Uni Flames","Flames",64,61,3,"W","199:58","22","67","32","3","8","37","19","59","32","17","20","85","27","14","41","7","13","5","4","6","18","22","64","10","2","6","16","22"
"2015",137294,"Sydney Uni Flames","Flames","away","Dandenong Rangers","Rangers",61,64,-3,"L","199:55","23","71","32","5","21","23","18","50","36","10","15","66","24","14","38","9","11","4","6","4","22","18","61","11","11","4","25","30"
"2015",137295,"Bendigo Spirit","Spirit","home","Melbourne Boomers","Boomers",81,74,7,"W","199:56","28","62","45","5","18","27","23","44","52","20","28","71","20","13","33","19","9","10","3","1","17","22","81","6","4","0","3","42"
"2015",137295,"Melbourne Boomers","Boomers","away","Bendigo Spirit","Spirit",74,81,-7,"L","199:56","27","57","47","11","21","52","16","36","44","9","20","45","22","7","29","14","12","1","1","3","22","17","74","10","8","4","12","24"
"2015",137296,"Townsville Fire","Fire","home","SEQ Stars","Stars",80,90,-10,"L","199:57","31","73","42","8","21","38","23","52","44","10","15","66","28","9","37","19","16","2","4","4","16","13","80","10","9","0","8","40"
"2015",137296,"SEQ Stars","Stars","away","Townsville Fire","Fire",90,80,10,"W","199:58","28","68","41","10","21","47","18","47","38","24","26","92","29","9","38","16","13","3","4","4","13","16","90","18","12","2","2","20"
"2015",137298,"Bendigo Spirit","Spirit","home","Sydney Uni Flames","Flames",81,66,15,"W","199:55","30","68","44","5","16","31","25","52","48","16","20","80","31","15","46","19","14","4","2","1","14","16","81","8","11","6","5","48"
"2015",137298,"Sydney Uni Flames","Flames","away","Bendigo Spirit","Spirit",66,81,-15,"L","199:56","28","72","38","5","21","23","23","51","45","5","6","83","19","8","27","14","8","3","1","2","16","14","66","13","7","0","17","36"
"2015",137299,"Dandenong Rangers","Rangers","home","Adelaide Lightning","Lightning",63,77,-14,"L","199:56","25","60","41","5","14","35","20","46","43","8","10","80","22","4","26","14","15","6","2","4","22","15","63","11","4","2","10","22"
"2015",137299,"Adelaide Lightning","Lightning","away","Dandenong Rangers","Rangers",77,63,14,"W","199:56","26","73","35","4","15","26","22","58","37","21","26","80","25","22","47","15","12","6","4","2","15","22","77","14","11","4","11","32"
"2015",137300,"SEQ Stars","Stars","home","UC Capitals","Capitals",115,75,40,"W","199:55","44","77","57","15","29","51","29","48","60","12","17","70","28","16","44","16","14","9","0","0","25","18","115","23","20","0","14","42"
"2015",137300,"UC Capitals","Capitals","away","SEQ Stars","Stars",75,115,-40,"L","199:56","25","58","43","4","14","28","21","44","47","21","26","80","17","1","18","9","17","3","0","0","18","25","75","9","2","2","32","26"
"2015",137301,"Perth Lynx","Lynx","home","Adelaide Lightning","Lightning",76,67,9,"W","199:56","28","65","43","7","22","31","21","43","48","13","19","68","24","7","31","19","6","2","2","5","16","19","76","14","8","0","11","30"
"2015",137301,"Adelaide Lightning","Lightning","away","Perth Lynx","Lynx",67,76,-9,"L","199:57","22","67","32","11","26","42","11","41","26","12","16","75","21","18","39","13","15","0","5","2","19","16","67","9","6","0","13","14"
"2015",137302,"Townsville Fire","Fire","home","UC Capitals","Capitals",97,83,14,"W","199:54","39","74","52","5","15","33","34","59","57","14","22","63","30","10","40","26","11","7","4","8","9","17","97","12","8","0","25","48"
"2015",137302,"UC Capitals","Capitals","away","Townsville Fire","Fire",83,97,-14,"L","199:56","33","73","45","11","27","40","22","46","47","6","6","100","19","7","26","18","15","1","8","4","17","9","83","8","6","0","17","36"
"2015",137303,"Melbourne Boomers","Boomers","home","Dandenong Rangers","Rangers",67,72,-5,"L","199:55","26","60","43","6","15","40","20","45","44","9","11","81","21","6","27","14","15","7","3","2","16","16","67","14","4","0","13","28"
"2015",137303,"Dandenong Rangers","Rangers","away","Melbourne Boomers","Boomers",72,67,5,"W","199:57","30","68","44","5","15","33","25","53","47","7","11","63","24","13","37","16","16","7","2","3","16","16","72","14","6","4","12","38"
"2015",137304,"Townsville Fire","Fire","home","Sydney Uni Flames","Flames",89,80,9,"W","199:57","35","67","52","4","14","28","31","53","58","15","22","68","30","10","40","11","12","7","1","3","11","20","89","12","14","0","15","50"
"2015",137304,"Sydney Uni Flames","Flames","away","Townsville Fire","Fire",80,89,-9,"L","199:56","32","74","43","8","20","40","24","54","44","8","11","72","24","9","33","18","15","4","3","1","21","10","80","13","4","0","22","32"
"2015",137305,"Adelaide Lightning","Lightning","home","Melbourne Boomers","Boomers",70,47,23,"W","199:54","24","76","31","5","21","23","19","55","34","17","22","77","21","20","41","18","15","18","2","0","15","19","70","22","11","0","10","30"
"2015",137305,"Melbourne Boomers","Boomers","away","Adelaide Lightning","Lightning",47,70,-23,"L","199:56","19","57","33","4","18","22","15","39","38","5","10","50","25","12","37","9","28","4","0","2","19","15","47","14","6","0","8","22"
"2015",137306,"Dandenong Rangers","Rangers","home","Bendigo Spirit","Spirit",82,74,8,"W","199:57","30","60","50","1","4","25","29","56","51","21","22","95","28","7","35","13","10","2","6","1","13","17","82","6","6","0","16","34"
"2015",137306,"Bendigo Spirit","Spirit","away","Dandenong Rangers","Rangers",74,82,-8,"L","199:57","30","81","37","9","31","29","21","50","42","5","7","71","18","11","29","14","8","5","1","6","17","13","74","3","12","2","4","32"
"2015",137307,"Perth Lynx","Lynx","home","Melbourne Boomers","Boomers",80,59,21,"W","199:54","35","77","45","10","25","40","25","52","48","0","1","0","18","18","36","23","8","8","3","2","13","12","80","26","22","0","11","36"
"2015",137307,"Melbourne Boomers","Boomers","away","Perth Lynx","Lynx",59,80,-21,"L","199:56","22","54","40","9","24","37","13","30","43","6","7","85","20","9","29","11","20","3","2","3","12","13","59","5","8","0","17","24"
"2015",137308,"UC Capitals","Capitals","home","Adelaide Lightning","Lightning",82,85,-3,"L","199:57","29","69","42","11","22","50","18","47","38","13","13","100","23","5","28","13","12","8","2","1","16","20","82","7","5","0","9","28"
"2015",137308,"Adelaide Lightning","Lightning","away","UC Capitals","Capitals",85,82,3,"W","199:56","34","72","47","7","16","43","27","56","48","10","16","62","30","11","41","21","15","5","1","2","20","16","85","8","13","2","14","44"
"2015",137309,"SEQ Stars","Stars","home","Sydney Uni Flames","Flames",92,73,19,"W","199:56","33","75","44","8","23","34","25","52","48","18","21","85","29","12","41","11","10","4","6","5","22","19","92","11","10","4","17","28"
"2015",137309,"Sydney Uni Flames","Flames","away","SEQ Stars","Stars",73,92,-19,"L","199:56","23","65","35","4","14","28","19","51","37","23","27","85","25","11","36","11","11","0","5","6","19","21","73","2","6","0","21","26"
"2015",137310,"Adelaide Lightning","Lightning","home","SEQ Stars","Stars",81,89,-8,"L","199:56","31","78","39","3","22","13","28","56","50","16","22","72","32","12","44","11","10","3","4","2","24","20","81","2","11","0","9","30"
"2015",137310,"SEQ Stars","Stars","away","Adelaide Lightning","Lightning",89,81,8,"W","199:55","29","74","39","7","20","35","22","54","40","24","28","85","37","11","48","15","8","4","2","4","20","24","89","3","11","0","9","28"
"2015",137311,"Perth Lynx","Lynx","home","SEQ Stars","Stars",71,87,-16,"L","199:57","27","72","37","12","36","33","15","36","41","5","6","83","22","12","34","15","21","3","0","1","22","10","71","6","9","0","0","26"
"2015",137311,"SEQ Stars","Stars","away","Perth Lynx","Lynx",87,71,16,"W","199:56","30","73","41","5","24","20","25","49","51","22","29","75","27","14","41","14","10","11","1","0","12","22","87","15","8","0","16","40"
"2015",137312,"Sydney Uni Flames","Flames","home","Dandenong Rangers","Rangers",73,77,-4,"L","199:55","27","70","38","7","18","38","20","52","38","12","15","80","20","6","26","14","14","8","4","5","15","13","73","16","0","0","12","28"
"2015",137312,"Dandenong Rangers","Rangers","away","Sydney Uni Flames","Flames",77,73,4,"W","199:56","31","67","46","4","10","40","27","57","47","11","13","84","33","10","43","19","18","2","5","4","13","15","77","14","8","0","17","38"
"2015",137313,"Melbourne Boomers","Boomers","home","Townsville Fire","Fire",60,84,-24,"L","199:53","25","68","36","7","21","33","18","47","38","3","4","75","18","10","28","12","15","2","1","2","19","15","60","14","9","2","12","24"
"2015",137313,"Townsville Fire","Fire","away","Melbourne Boomers","Boomers",84,60,24,"W","199:54","31","67","46","6","14","42","25","53","47","16","20","80","26","13","39","16","12","6","2","1","15","19","84","20","9","2","28","44"
"2015",137314,"Bendigo Spirit","Spirit","home","Townsville Fire","Fire",63,75,-12,"L","199:57","26","75","34","5","21","23","21","54","38","6","8","75","18","20","38","14","16","4","5","5","20","11","63","7","17","0","10","26"
"2015",137314,"Townsville Fire","Fire","away","Bendigo Spirit","Spirit",75,63,12,"W","199:57","27","66","40","7","18","38","20","48","41","14","17","82","24","12","36","16","14","6","5","5","11","19","75","6","11","0","17","28"
"2015",137315,"UC Capitals","Capitals","home","Dandenong Rangers","Rangers",69,73,-4,"L","199:55","29","63","46","5","21","23","24","42","57","6","10","60","28","6","34","17","18","8","10","2","12","12","69","4","2","2","15","44"
"2015",137315,"Dandenong Rangers","Rangers","away","UC Capitals","Capitals",73,69,4,"W","199:55","29","81","35","6","11","54","23","70","32","9","11","81","25","13","38","11","10","10","2","10","12","12","73","20","14","2","6","28"
"2015",137316,"Townsville Fire","Fire","home","Dandenong Rangers","Rangers",89,49,40,"W","199:54","31","65","47","10","25","40","21","40","52","17","23","73","34","15","49","18","16","3","5","3","16","20","89","17","11","2","15","40"
"2015",137316,"Dandenong Rangers","Rangers","away","Townsville Fire","Fire",49,89,-40,"L","199:55","20","74","27","3","19","15","17","55","30","6","8","75","21","14","35","9","17","5","3","5","20","16","49","8","10","0","7","22"
"2015",137317,"UC Capitals","Capitals","home","Perth Lynx","Lynx",80,77,3,"W","199:57","30","59","50","6","16","37","24","43","55","14","18","77","28","8","36","19","23","7","4","0","14","17","80","11","9","0","0","40"
"2015",137317,"Perth Lynx","Lynx","away","UC Capitals","Capitals",77,80,-3,"L","199:55","29","74","39","12","33","36","17","41","41","7","10","70","16","15","31","15","16","15","0","4","17","14","77","22","11","2","10","28"
"2015",137318,"Sydney Uni Flames","Flames","home","Perth Lynx","Lynx",85,88,-3,"L","199:55","32","68","47","7","18","38","25","50","50","14","14","100","18","9","27","20","16","7","1","2","11","14","85","12","8","0","26","44"
"2015",137318,"Perth Lynx","Lynx","away","Sydney Uni Flames","Flames",88,85,3,"W","199:56","35","71","49","11","26","42","24","45","53","7","10","70","19","13","32","17","14","4","2","1","14","11","88","20","13","0","15","40"
"2015",137319,"Melbourne Boomers","Boomers","home","Adelaide Lightning","Lightning",62,88,-26,"L","199:55","25","69","36","8","16","50","17","53","32","4","6","66","18","13","31","13","24","5","3","7","18","12","62","6","18","0","17","22"
"2015",137319,"Adelaide Lightning","Lightning","away","Melbourne Boomers","Boomers",88,62,26,"W","199:56","35","71","49","2","11","18","33","60","55","16","20","80","23","12","35","17","13","12","7","3","12","18","88","31","11","4","10","48"
"2015",137320,"Bendigo Spirit","Spirit","home","Adelaide Lightning","Lightning",78,92,-14,"L","199:56","28","62","45","5","18","27","23","44","52","17","21","80","18","6","24","13","16","6","1","3","19","19","78","14","7","4","9","38"
"2015",137320,"Adelaide Lightning","Lightning","away","Bendigo Spirit","Spirit",92,78,14,"W","199:56","37","67","55","6","14","42","31","53","58","12","16","75","24","8","32","14","11","2","3","1","19","19","92","17","9","0","18","40"
"2015",137321,"SEQ Stars","Stars","home","UC Capitals","Capitals",81,76,5,"W","199:56","31","77","40","6","17","35","25","60","41","13","19","68","24","15","39","18","12","9","3","7","10","16","81","12","16","0","18","42"
"2015",137321,"UC Capitals","Capitals","away","SEQ Stars","Stars",76,81,-5,"L","199:56","31","73","42","7","22","31","24","51","47","7","10","70","31","11","42","16","17","6","7","3","16","9","76","16","7","2","9","34"
"2015",137322,"Perth Lynx","Lynx","home","Townsville Fire","Fire",82,69,13,"W","199:53","35","83","42","8","26","30","27","57","47","4","8","50","22","12","34","16","6","11","1","3","26","11","82","20","13","2","17","36"
"2015",137322,"Townsville Fire","Fire","away","Perth Lynx","Lynx",69,82,-13,"L","199:54","24","56","42","2","17","11","22","39","56","19","28","67","33","6","39","12","21","2","3","1","11","26","69","6","6","2","11","40"
"2015",137323,"Sydney Uni Flames","Flames","home","Bendigo Spirit","Spirit",90,83,7,"W","199:56","32","65","49","8","17","47","24","48","50","18","18","100","21","11","32","19","19","7","5","4","15","21","90","18","16","0","22","40"
"2015",137323,"Bendigo Spirit","Spirit","away","Sydney Uni Flames","Flames",83,90,-7,"L","199:57","35","79","44","6","18","33","29","61","47","7","11","63","20","16","36","8","18","10","4","5","21","15","83","26","19","0","8","54"
"2015",137324,"Dandenong Rangers","Rangers","home","SEQ Stars","Stars",64,88,-24,"L","199:53","22","62","35","3","16","18","19","46","41","17","28","60","23","8","31","9","14","2","3","4","23","22","64","8","4","5","20","26"
"2015",137324,"SEQ Stars","Stars","away","Dandenong Rangers","Rangers",88,64,24,"W","199:56","32","71","45","12","27","44","20","44","45","12","22","54","31","14","45","19","16","7","4","3","22","23","88","17","14","7","16","24"
"2015",137325,"UC Capitals","Capitals","home","Bendigo Spirit","Spirit",78,71,7,"W","199:57","30","70","42","6","18","33","24","52","46","12","15","80","27","13","40","19","12","9","8","2","12","14","78","13","13","2","20","34"
"2015",137325,"Bendigo Spirit","Spirit","away","UC Capitals","Capitals",71,78,-7,"L","200:00","26","71","36","9","22","40","17","49","34","10","13","76","24","15","39","11","16","8","2","8","14","12","71","13","8","2","5","26"
"2015",137326,"Adelaide Lightning","Lightning","home","Townsville Fire","Fire",57,64,-7,"L","199:56","23","77","29","6","26","23","17","51","33","5","8","62","27","16","43","19","13","8","4","4","22","11","57","9","10","0","5","22"
"2015",137326,"Townsville Fire","Fire","away","Adelaide Lightning","Lightning",64,57,7,"W","199:56","20","61","32","5","17","29","15","44","34","19","28","67","29","13","42","13","16","6","4","4","12","22","64","5","6","0","20","22"
"2015",137327,"Melbourne Boomers","Boomers","home","SEQ Stars","Stars",81,67,14,"W","199:56","28","60","46","15","25","60","13","35","37","10","11","90","29","10","39","18","17","1","3","0","18","12","81","12","8","2","12","20"
"2015",137327,"SEQ Stars","Stars","away","Melbourne Boomers","Boomers",67,81,-14,"L","199:56","28","78","35","3","16","18","25","62","40","8","12","66","19","17","36","11","11","3","0","3","13","17","67","12","2","0","28","38"
"2015",270583,"Dandenong Rangers","Rangers","home","SEQ Stars","Stars",82,86,-4,"L","199:56","32","75","42","5","15","33","27","60","45","13","20","65","21","8","29","14","13","7","1","4","28","16","82","17","4","0","14","40"
"2015",270583,"SEQ Stars","Stars","away","Dandenong Rangers","Rangers",86,82,4,"W","199:56","27","58","46","7","18","38","20","40","50","25","33","75","32","9","41","14","23","3","4","1","16","28","86","12","8","2","21","34"
"2015",270584,"Townsville Fire","Fire","home","Perth Lynx","Lynx",72,91,-19,"L","199:56","27","61","44","6","15","40","21","46","45","12","15","80","29","5","34","14","13","3","3","1","17","15","72","5","6","4","13","36"
"2015",270584,"Perth Lynx","Lynx","away","Townsville Fire","Fire",91,72,19,"W","199:54","32","78","41","14","34","41","18","44","40","13","14","92","26","16","42","13","7","6","1","3","15","17","91","16","9","2","11","20"
"2015",270585,"Townsville Fire","Fire","home","SEQ Stars","Stars",91,71,20,"W","199:54","34","83","40","11","31","35","23","52","44","12","15","80","31","15","46","20","14","5","5","4","17","16","91","20","17","2","12","44"
"2015",270585,"SEQ Stars","Stars","away","Townsville Fire","Fire",71,91,-20,"L","199:55","27","69","39","8","25","32","19","44","43","9","14","64","26","9","35","18","18","7","4","5","16","17","71","17","4","2","12","28"
"2015",270586,"Perth Lynx","Lynx","home","Townsville Fire","Fire",57,73,-16,"L","191:39","19","67","28","8","28","28","11","39","28","11","14","78","25","8","33","8","12","6","5","1","21","14","57","5","9","0","5","14"
"2015",270586,"Townsville Fire","Fire","away","Perth Lynx","Lynx",73,57,16,"W","199:54","22","60","36","6","16","37","16","44","36","23","30","76","35","10","45","16","16","1","1","5","14","21","73","17","14","2","11","28"
"2015",270587,"Townsville Fire","Fire","home","Perth Lynx","Lynx",80,70,10,"W","199:55","26","60","43","10","15","66","16","45","35","18","23","78","31","6","37","15","18","7","2","4","15","14","80","23","0","0","4","26"
"2015",270587,"Perth Lynx","Lynx","away","Townsville Fire","Fire",70,80,-10,"L","199:58","26","71","36","8","30","26","18","41","43","10","16","62","24","13","37","13","17","6","4","2","14","15","70","28","16","0","7","34"
